
NO         ./textures/bluestone.xpm

SO         ./textures/purplestone.xpm

WE ./textures/redbrick.xpm

EA        ./textures/colorstone.xpm

S          ./textures/barrel.xpm

R 		1920 1080


        1111111111111111111111111
        1200000000112002220000021
        1011000001112000200020021
        1001000000000000000020021
111111111011000001110000000000001
120000000011000001110111110111111
11110111111111011100000010001
11110111111111011101010010001
11000000110101011100000000001
10000000000000001100000010001
10000000000000000001010010001
11000001110101011111011110W0111
11110111 1110101 101111010001
11111111 1111111 111111111111
