
NO         ./textures/bluestone.xpm

SO         ./textures/purplestone.xpm

WE ./textures/redbrick.xpm

EA        ./textures/colorstone.xpm

S          ./textures/pillar.xpm

R 		1920 1080

111111111111111111111111111111
100000222222222222222222200001
100000022222222222222222000001
100000002222222222222220000001
100000000222222222222200000001
100000000022222222222000000001
100000000002222222220000000001
100000000000222222200000000001
100000000000022222000000000001
100000000000002220000000000001
100000000000000200000000000001
100000000000000000000000000001
100000000000000N00000000000001
100000000000000000000000000001
111111111111111111111111111111
